Abbott	Hill
Abernathy*	Lubbock
Hale
AbileneCounty seat*	Taylor
Jones
Ackerly*	Dawson
Martin
Addison	Dallas
Adrian	Oldham
Agua Dulce	Nueces
Alamo	Hidalgo
Alamo Heights	Bexar
AlbanyCounty seat	Shackelford
Aledo	Parker
AliceCounty seat	Jim Wells
Allen	Collin
Alpine	Brewster
Alton	Hidalgo
Alvarado	Johnson
Alvin	Brazoria
AmarilloCounty seat*	Potter
Randall
Ames	Liberty
Amherst	Lamb
AnahuacCounty seat	Chambers
AndersonCounty seat	Grimes
AndrewsCounty seat	Andrews
AngletonCounty seat	Brazoria
Angus	Navarro
Anna	Collin
AnsonCounty seat	Jones
Anton	Hockley
Appleby	Nacogdoches
Aquilla	Hill
Aransas Pass*	San Patricio
Aransas
Nueces
Archer CityCounty seat	Archer
Arcola	Fort Bend
Argyle	Denton
Arlington	Tarrant
Arp	Smith
Asherton	Dimmit
AthensCounty seat	Henderson
Atlanta	Cass
Aubrey	Denton
Aurora	Wise
AustinCounty seat*	Travis
Williamson
Hays
Austwell	Refugio
Avery	Red River
Azle*	Parker
Tarrant
Bailey	Fannin
BairdCounty seat	Callahan
Balch Springs	Dallas
Balcones Heights	Bexar
BallingerCounty seat	Runnels
Balmorhea	Reeves
BanderaCounty seat	Bandera
Bangs	Brown
Bardwell	Ellis
Barry	Navarro
Barstow	Ward
Bartlett*	Williamson
Bell
BastropCounty seat	Bastrop
Bay CityCounty seat	Matagorda
Bayou Vista	Galveston
Baytown*	Harris
Chambers
Beach City	Chambers
Beasley	Fort Bend
BeaumontCounty seat	Jefferson
Beckville	Panola
Bedford	Tarrant
Bedias	Grimes
Bee Cave	Travis
BeevilleCounty seat	Bee
Bellaire	Harris
Bellevue	Clay
Bellmead	McLennan
BellvilleCounty seat	Austin
BeltonCounty seat	Bell
Benavides	Duval
Benbrook	Tarrant
BenjaminCounty seat	Knox
Bertram	Burnet
Beverly Hills	McLennan
Bevil Oaks	Jefferson
Big LakeCounty seat	Reagan
Big SpringCounty seat	Howard
Big Wells	Dimmit
Bishop	Nueces
Blackwell*	Nolan
Coke
Blanco	Blanco
Blessing	Matagorda
Blossom	Lamar
Blue Mound	Tarrant
Blue Ridge	Collin
BoerneCounty seat	Kendall
Bogata	Red River
BonhamCounty seat	Fannin
Borger	Hutchinson
Bovina	Parmer
Bowie	Montague
BrackettvilleCounty seat	Kinney
BradyCounty seat	McCulloch
Brazoria	Brazoria
Brazos Bend	Hood
Brazos Country	Austin
BreckenridgeCounty seat	Stephens
Bremond	Robertson
BrenhamCounty seat	Washington
Briaroaks	Johnson
Bridge City	Orange
Bridgeport	Wise
Brookshire	Waller
Brookside Village	Brazoria
Browndell	Jasper
BrownfieldCounty seat	Terry
Brownsboro	Henderson
BrownsvilleCounty seat	Cameron
BrownwoodCounty seat	Brown
Bruceville-Eddy*	McLennan
Falls
BryanCounty seat	Brazos
Bryson	Jack
Buda	Hays
Buffalo	Leon
Bulverde	Comal
Bunker Hill Village	Harris
Burkburnett	Wichita
Burke	Angelina
Burleson*	Johnson
Tarrant
BurnetCounty seat	Burnet
Byers	Clay
Cactus	Moore
Caddo Mills	Hunt
CaldwellCounty seat	Burleson
Callisburg	Cooke
Calvert	Robertson
CameronCounty seat	Milam
Camp Wood	Real
Campbell	Hunt
CanadianCounty seat	Hemphill
CantonCounty seat	Van Zandt
CanyonCounty seat	Randall
Carmine	Fayette
Carrizo SpringsCounty seat	Dimmit
Carrollton*	Denton
Dallas
Collin
CarthageCounty seat	Panola
Cashion Community	Wichita
Castle Hills	Bexar
Castroville	Medina
Cedar Hill*	Dallas
Ellis
Cedar Park	Travis
Williamson
Celeste	Hunt
Celina*	Collin
Denton
CenterCounty seat	Shelby
CentervilleCounty seat	Leon
Chandler	Henderson
ChanningCounty seat	Hartley
Charlotte	Atascosa
Chico	Wise
ChildressCounty seat	Childress
Chillicothe	Hardeman
China	Jefferson
Chireno	Nacogdoches
Cibolo*	Guadalupe
Bexar
Cisco	Eastland
ClarendonCounty seat	Donley
ClarksvilleCounty seat	Red River
Clarksville City*	Gregg
Upshur
ClaudeCounty seat	Armstrong
Clear Lake Shores	Galveston
CleburneCounty seat	Johnson
Cleveland	Liberty
Clifton	Bosque
Clute	Brazoria
Clyde	Callahan
Cockrell Hill	Dallas
ColdspringCounty seat	San Jacinto
ColemanCounty seat	Coleman
College Station	Brazos
Colleyville	Tarrant
Colmesneil	Tyler
Colorado CityCounty seat	Mitchell
ColumbusCounty seat	Colorado
ComancheCounty seat	Comanche
Combine*	Kaufman
Dallas
Commerce	Hunt
ConroeCounty seat	Montgomery
Converse	Bexar
Cool	Parker
CooperCounty seat	Delta
Coppell*	Dallas
Denton
Copperas Cove*	Coryell
Lampasas
Bell
Corinth	Denton
Corpus ChristiCounty seat*	Nueces
Kleberg
San Patricio
Aransas
CorsicanaCounty seat	Navarro
Cottonwood	Kaufman
Cottonwood Shores	Burnet
CotullaCounty seat	La Salle
Coupland	Williamson
Cove	Chambers
Covington	Hill
Coyote Flats	Johnson
Crandall	Kaufman
CraneCounty seat	Crane
Cranfills Gap	Bosque
Creedmoor	Travis
Cresson*	Hood
Johnson
Parker
CrockettCounty seat	Houston
CrosbytonCounty seat	Crosby
CrowellCounty seat	Foard
Crowley*	Tarrant
Johnson
Crystal CityCounty seat	Zavala
CueroCounty seat	DeWitt
Cumby	Hopkins
Cushing	Nacogdoches
Cut and Shoot	Montgomery
DaingerfieldCounty seat	Morris
Daisetta	Liberty
DalhartCounty seat*	Dallam
Hartley
DallasCounty seat*	Dallas
Collin
Denton
Kaufman
Rockwall
Dalworthington Gardens	Tarrant
Danbury	Brazoria
Dayton	Liberty
Dayton Lakes	Liberty
De Leon	Comanche
Dean	Clay
DecaturCounty seat	Wise
DeCordova	Hood
Deer Park	Harris
DeKalb	Bowie
Dell City	Hudspeth
Del RioCounty seat	Val Verde
Denison	Grayson
DentonCounty seat	Denton
Deport	Lamar
Red River
DeSoto	Dallas
Devers	Liberty
Devine	Medina
Diboll	Angelina
DickensCounty seat	Dickens
Dickinson	Galveston
Dilley	Frio
DimmittCounty seat	Castro
Donna	Hidalgo
Dorchester	Grayson
Dripping Springs	Hays
Driscoll	Nueces
Dublin	Erath
DumasCounty seat	Moore
Duncanville	Dallas
Eagle Lake	Colorado
Eagle PassCounty seat	Maverick
Early	Brown
Earth	Lamb
East Bernard	Wharton
East Mountain*	Upshur
Gregg
East Tawakoni	Rains
EastlandCounty seat	Eastland
Easton*	Gregg
Rusk
Ector	Fannin
Edcouch	Hidalgo
Eden	Concho
EdinburgCounty seat	Hidalgo
EdnaCounty seat	Jackson
Edom	Van Zandt
El Campo	Wharton
El Cenizo	Webb
El Lago	Harris
El PasoCounty seat	El Paso
EldoradoCounty seat	Schleicher
Electra	Wichita
Elgin*	Bastrop
Travis
Elmendorf	Bexar
Elsa	Hidalgo
EmoryCounty seat	Rains
Encinal	La Salle
Ennis	Ellis
Escobares	Starr
Euless	Tarrant
Eureka	Navarro
Eustace	Henderson
Everman	Tarrant
Fair Oaks Ranch*	Bexar
Kendall
Comal
FairfieldCounty seat	Freestone
FalfurriasCounty seat	Brooks
Falls City	Karnes
Farmers Branch	Dallas
Farmersville	Collin
FarwellCounty seat	Parmer
Fate	Rockwall
Fayetteville	Fayette
Ferris*	Ellis
Dallas
Florence	Williamson
FloresvilleCounty seat	Wilson
FloydadaCounty seat	Floyd
Follett	Lipscomb
Forest Hill	Tarrant
Forney	Kaufman
Forsan	Howard
Fort StocktonCounty seat	Pecos
Fort WorthCounty seat*	Tarrant
Denton
Parker
Wise
FranklinCounty seat	Robertson
FredericksburgCounty seat	Gillespie
Freeport	Brazoria
Freer	Duval
Friendswood*	Galveston
Harris
Brazoria
Friona	Parmer
Frisco*	Collin
Denton
Fritch*	Hutchinson
Carson
Frost	Navarro
Fruitvale	Van Zandt
Fulshear	Fort Bend
GainesvilleCounty seat	Cooke
Galena Park	Harris
Gallatin	Cherokee
GalvestonCounty seat	Galveston
Ganado	Jackson
Garden Ridge	Comal
Garland	Collin
Dallas
Rockwall
Garrison	Nacogdoches